###########################################################
#.................#...........#..................#........#
#.##########.######.########.##.#########################.#
#.#...#.................#...............................#.#
#.#.#############.######.#####.####.###.#.#####.#######.#.#
#.#.#..........#.......#........#......#......#.......###.#
#.#.#.######################################.###.######.#.#
#.....#..................#.....................##.....#.#.#
#.#####.#.##################################.####.#.#.#...#
#.#.#.#.#.............#.................#.........#.#.###.#
#.#.#.#.#.#################.#.#######.###.#######.#.#.#...#
#.#.#.###.#..............#..#..#........#.......#.#.#.#.#.#
#.#.#.#.#.#.##.########.##############.########.#.#.#.#.###
#.#.#.#.#.#.#.....#.........................#.#.#.###.#.#.#
#.#.#.#.#.#.#.######################.#####.##.#.#.#.#.#.#.#
#.#.#.#.#.#.#.#...#.................##..........#.#.#.#.#.#
#.#.#.#.#....#..#.##.######################.#.#.#.#.#.#.#.#
#.#.#.#.###.#.###..#..................#...#.#.###.#.#...#.#
#.#.#...#.#.#.#.#.##.####################.#.#.#.###.#.#.#.#
#.#.#.#.#.###.#.#.##...##...###.#.#.#...#.#.#.#.#...#.#.#.#
#.#.#.#.#.#.#...#.#.##...##.......#.###.#.#.#.#...#.#.#.#.#
#.#.#.###.#.#.#.#.#..###..#.#.##.##..##...#.#.#.#.#.#.#.#.#
###.#.#.#.#.#.#...#.#.##.#.#..##.#..##.#.##.#.#.###.#.###.#
#.#.#.#.#.#.#.#.#.#.#.#....##.##.##......##.#.#.#.#...#.#.#
#.#.#.#.#.#.#.#.#.#.....#.#.##......####.##.#.#.#.#.#.#.#.#
#.#.#...#.#...#.#.#.###.#......##.##..##....#.#.#.#.#.#.#.#
#.#.#.###...#.#.#.#.#.####.###..#....#.##.#.##..#.#.#.#.#.#
#.#.#.#.#.#.#.#.#.#....#.###.#.#.####..#..#.#..##.#.#.#...#
#.#.#.#.###.#.#.#....##..##..........#.##.#.#.###.#.#...#.#
S.#.....#.#.#.#.#.##..##...##.#.#.#.#...#.#.#.#.#.##..###.E
#.#.#.#...#.#.###.#..#...#....##...#..#..#..#.#.#.#.#...#.#
#.#.#.#.#.#.#.#.#.#.#.#.#...#.##.#...######.#.#.#.#.#.#.#.#
#.#.#.#.#.#.#.#.#.##....#.#.#.##.##.##...##.#.#.#.#.#.#.#.#
#.#.#.#.#.#.#.#.#.#..#.##.#..##...#.#..#..#.###.#.#.#.#.#.#
#.#..##.#.#.#.#.#.##..##.#.#...##.##..###.#.#.#.#...#.#.#.#
#.#.#.#.#.#.#.#.#.##.##.......###....##.#.#.#.#...#.#.#.#.#
#.#.#.#.#.#.#.#.#.#....####.#.##..###.#..##.#...#.###.#.#.#
#.###.#.#.#.###.#.##.###....##...##.#...###.#.###.#.#.#.#.#
#.#...#..##.#.#.#.#####.######.##.#....##.###.#.#.....#.#.#
#.#.###.#...#...#.####..##.##..##..#.#.##...#.#...#.#.#.#.#
#.#.#.#.#.#.#.#.#.##...###.#.#...#.#..#...#.#.#.#.##..#.#.#
#.#.#.#...#.#.#.#.#..#.........#....#...#.#.#.#.#.#.#.#.#.#
#.#.#.#.#.#.#.#.##.##########.###.####.####.###.#.#.#.###.#
#.#.#.#.###.#.#..........#....#.........#...#.#.#.#.#.#...#
#.#...#.#.#.#.####################.########.#.#..##.#.###.#
#...###.#..##.............#........#..#.......#.#.#.#.#.#.#
#.#.#.###.#.#.########.########.#####.#########.#.#...#...#
#.#.#.#.#.#......#..........................#...#.#.###.#.#
#.#.#.#.#.##########.###############.############.#.#.#.###
#.#.#.#.#...#............#..................#.....#.#...#.#
#..##.#.#.#####.##########.##.######.##########.###.#.#.#.#
#.#.#.#...............#.#..#........#...............#.#.#.#
#.#.#.#################.##.##########################.#.#.#
#...#......................#...#......................#.#.#
#.#.######.##############.###.#########################.#.#
#.#............#.........................#....#.........#.#
#.##########.###############################.##.#########.#
#..........#..........................#...................#
###########################################################
